
+++++++++++
+c+  y  +c+
+ + +++ + +
+ +o+  l  +
+ +++++++ +
+r   s+  g+
+ +++ +++ +
+ +p   t  +
+ +++++ + +
+c+  b  +c+
+++++++++++